一目瞭然	一目了然
八濛山	八濛山
上鍊	上链
么麼	幺麽
么麽	幺麽
千鍾粟	千锺粟
大目乾連冥間救母變文	大目乾连冥间救母变文
幺麼	幺麽
幺麼小丑	幺麽小丑
幺麼小醜	幺麽小丑
不瞭解	不了解
反反覆覆	反反复复
反覆	反复
反覆性	反复性
反覆思量	反复思量
反覆思維	反复思维
手鍊	手链
文錦覆阱	文锦复阱
木吒	木吒
以功覆過	以功复过
以免藉口	以免借口
出醜狼藉	出丑狼藉
尼乾陀	尼乾陀
申覆	申复
示覆	示复
名覆金甌	名复金瓯
回覆	回复
有序	有序
老態龍鍾	老态龙锺
彷彿	仿佛
彷徨	彷徨
扭轉乾坤	扭转乾坤
找藉口	找借口
李乾德	李乾德
李澤鉅	李泽钜
李鍊福	李链福
李鍾郁	李锺郁
沈沒	沉没
沈沒成本	沉没成本
沈船	沉船
沈積	沉积
沈默	沉默
肘手鍊足	肘手链足
見覆	见复
角徵	角徵
角徵羽	角徵羽
侔德覆載	侔德复载
函覆	函复
拉鍊	拉链
拉鍊工程	拉链工程
於世成	於世成
於乎	於乎
於仲完	於仲完
於竹屋	於竹屋
於邑	於邑
於其一	於其一
於呼哀哉	於呼哀哉
於坦	於坦
於忠祥	於忠祥
於則	於则
於勇明	於勇明
於倫	於伦
於崇文	於崇文
於惟一	於惟一
於敖	於敖
於梨華	於梨华
於清言	於清言
於陵子	於陵子
於單	於单
於琳	於琳
於菟	於菟
於潛	於潜
於穆	於穆
於戲	於戏
明瞭	明了
明覆	明复
狐藉虎威	狐借虎威
金吒	金吒
金鍊	金链
宫商角徵羽	宫商角徵羽
拜覆	拜复
流徵	流徵
牴牾	抵牾
牴觸	抵触
珍珠項鍊	珍珠项链
甚鉅	甚钜
盼既示覆	盼既示复
計畫	计划
重覆	重复
凌藉	凌借
哪吒	哪吒
射覆	射复
書中自有千鍾粟	书中自有千锺粟
浪蕩乾坤	浪荡乾坤
神祇	神祇
素藉	素借
茵藉	茵借
衹見樹木	只见树木
衹見樹木不見森林	只见树木不见森林
衹得	只得
酒逢知己千鍾少	酒逢知己千锺少
酒逢知己千鍾少話不投機半句多	酒逢知己千锺少话不投机半句多
乾元	乾元
乾旦	乾旦
乾宅	乾宅
乾卦	乾卦
乾坤	乾坤
乾坤一擲	乾坤一掷
乾坤大挪移	乾坤大挪移
乾坤再造	乾坤再造
乾紅	乾红
乾乾脆脆	干干脆脆
乾乾淨淨	干干净净
乾清宮	乾清宫
乾盛世	乾盛世
乾造	乾造
乾陵	乾陵
乾象	乾象
乾隆	乾隆
乾隆年間	乾隆年间
乾隆皇帝	乾隆皇帝
乾道	乾道
乾嘉	乾嘉
乾圖	乾图
乾綱	乾纲
乾縣	乾县
乾斷	乾断
乾曜	乾曜
康乾	康乾
張法乾	张法乾
情有獨鍾	情有独锺
旋乾轉坤	旋乾转坤
旋轉乾坤	旋转乾坤
旋轉乾坤之力	旋转乾坤之力
畢昇	毕昇
袖裏乾坤	袖里乾坤
袖裡乾坤	袖里乾坤
郭子乾	郭子乾
傢俱	家具
壺裏乾坤	壶里乾坤
壺裡乾坤	壶里乾坤
朝乾夕惕	朝乾夕惕
無序	无序
發覆	发复
答覆	答复
貂覆額	貂复额
買臣覆水	买臣复水
鈞覆	钧复
雁杳魚沈	雁杳鱼沉
項鍊	项链
黄鍾公	黄锺公
傷亡枕藉	伤亡枕藉
滑藉	滑借
萬鍾	万锺
稟覆	禀复
鉅子	钜子
鉅防	钜防
鉅萬	钜万
電覆	电复
綜合症	综合征
蒜薹	蒜薹
踅門瞭戶	踅门了户
鉸鍊	铰链
銀鍊	银链
頗覆	颇复
麼些族	麽些族
徵羽摩柯	徵羽摩柯
徵弦	徵弦
徵音	徵音
徵絃	徵弦
徵調	徵调
徵聲	徵声
樊於期	樊於期
憑藉	凭借
憑藉着	凭借着
憑藉著	凭借着
據瞭解	据了解
篤麼	笃麽
蕓薹	芸薹
蕩覆	荡复
蕭乾	萧乾
錢鍾書	钱锺书
頸鍊	颈链
龍鍾	龙锺
瞭如	了如
瞭如指掌	了如指掌
瞭若指掌	了若指掌
瞭望	瞭望
瞭然	了然
瞭然於心	了然于心
瞭解	了解
瞭解到	了解到
醞藉	酝借
鍊子	链子
鍊形	链形
鍊條	链条
鍊墜	链坠
鍊錘	链锤
鍊鎖	链锁
鍛鍾	锻锺
鍾重發	锺重发
鍾馗	锺馗
鍾萬梅	锺万梅
鍾繇	锺繇
鍾鍛	锺锻
雖覆能復	虽覆能复
簡單明瞭	简单明了
藉口	借口
藉手	借手
藉方	借方
藉代	借代
藉以	借以
藉卉	借卉
藉由	借由
藉此	借此
藉此機會	借此机会
藉助	借助
藉助於	借助于
藉故	借故
藉故推辭	借故推辞
藉甚	借甚
藉草枕塊	借草枕块
藉寇兵	借寇兵
藉寇兵齎盜糧	借寇兵赍盗粮
藉條	借条
藉着	借着
藉喻	借喻
藉著	借着
藉詞	借词
藉資	借资
藉槁	借槁
藉端	借端
藉端生事	借端生事
藉箸代籌	借箸代筹
藉據	借据
藉機	借机
藉藉	藉藉
藉藉无名	藉藉无名
藉讀	借读
覆上	复上
覆文	复文
覆成	复成
覆住	复住
覆呈	复呈
覆命	复命
覆宗	复宗
覆杯	复杯
覆盂	复盂
覆育	复育
覆信	复信
覆冒	复冒
覆按	复按
覆盆	覆盆
覆盆子	覆盆子
覆校	复校
覆逆	复逆
覆帳	复帐
覆鹿尋蕉	复鹿寻蕉
覆鹿遺蕉	复鹿遗蕉
覆瓿	复瓿
覆電	复电
覆鼎	复鼎
覆墓	复墓
覆盤	覆盘
覆蕉尋鹿	复蕉寻鹿
覆幬	复帱
覆醢	复醢
覆醬瓿	复酱瓿
覆露	复露
鎖鍊	锁链
顛倒乾坤	颠倒乾坤
顛乾倒坤	颠乾倒坤
癥候	征候
籌畫	筹划
鐵鍊	铁链
露覆	露复
顧藉	顾借
變徵	变徵
變徵之音	变徵之音
變徵之聲	变徵之声
躪藉	躏借
鑽石項鍊	钻石项链
內	内
凶	凶
勻	匀
弔	吊
戶	户
冊	册
朮	术
氾	泛
丟	丢
亙	亘
兇	凶
吒	咤
奼	姹
汎	泛
汙	污
糹	纟
佇	伫
佈	布
佔	占
兌	兑
別	别
刪	删
吳	吴
吶	呐
呂	吕
囪	囱
壯	壮
夾	夹
妝	妆
床	床
彷	彷
決	决
沒	没
沖	冲
灶	灶
災	灾
皁	皂
禿	秃
糺	𫄙
見	见
訁	讠
貝	贝
車	车
阪	阪
並	并
亞	亚
併	并
來	来
侖	仑
兒	儿
兩	两
協	协
卹	恤
姍	姗
屆	届
岡	冈
彔	录
彿	佛
戔	戋
拋	抛
於	於
昇	升
東	东
歿	殁
況	况
泝	溯
爭	争
牀	床
狀	状
秈	籼
糾	纠
羋	芈
臥	卧
虯	虬
軋	轧
釒	钅
長	长
門	门
侶	侣
侷	局
俁	俣
係	系
俓	𠇹
俔	伣
俠	侠
俥	伡
俬	私
兗	兖
冑	胄
剄	刭
則	则
剋	克
剎	刹
勁	劲
卻	却
卽	即
厙	厍
咼	呙
奐	奂
姦	奸
屍	尸
巹	卺
帥	帅
彥	彦
後	后
恆	恒
枴	拐
柵	栅
柺	拐
査	查
洩	泄
洶	汹
為	为
牴	牴
盃	杯
祇	祇
紀	纪
紂	纣
約	约
紅	红
紆	纡
紇	纥
紈	纨
紉	纫
䊷	䌶
苧	苎
訂	订
訃	讣
計	计
貞	贞
貟	贠
負	负
軌	轨
軍	军
釓	钆
釔	钇
閂	闩
韋	韦
頁	页
風	风
飛	飞
飠	饣
鳬	凫
倀	伥
倆	俩
倈	俫
倉	仓
個	个
們	们
倖	幸
倫	伦
倲	㑈
凈	净
凍	冻
剗	刬
剛	刚
剝	剥
勑	𠡠
員	员
哯	𠯟
唄	呗
唓	𪠳
娛	娱
㛝	𫝦
孫	孙
宮	宫
屓	屃
峯	峰
峴	岘
島	岛
峽	峡
師	师
庫	库
弳	弪
徑	径
恥	耻
悅	悦
悞	悮
挩	捝
挱	挲
挾	挟
旂	旗
時	时
晉	晋
書	书
氣	气
浹	浃
涇	泾
涗	涚
烏	乌
狹	狭
狽	狈
畝	亩
皰	疱
眝	𪾣
眞	真
祕	秘
竚	𥩟
紋	纹
納	纳
紐	纽
紓	纾
純	纯
紕	纰
紖	纼
紗	纱
紘	纮
紙	纸
級	级
紛	纷
紜	纭
紝	纴
紟	𫄛
紡	纺
脅	胁
脈	脉
芻	刍
茲	兹
荊	荆
衹	只
覎	觃
訊	讯
訌	讧
討	讨
訐	讦
訑	𫍙
訒	讱
訓	训
訕	讪
訖	讫
託	讬
記	记
豈	岂
財	财
貢	贡
軏	𫐄
軑	轪
軒	轩
軔	轫
軕	𫐅
迴	回
郟	郏
釕	钌
釗	钊
釘	钉
釙	钋
釚	𫟲
針	针
釟	𫓥
閃	闪
陘	陉
陝	陕
陞	升
陣	阵
隻	只
飢	饥
飣	饤
馬	马
鬥	斗
乾	乾
偉	伟
偑	㐽
側	侧
偵	侦
偽	伪
剮	剐
動	动
務	务
匭	匦
區	区
厠	厕
參	参
叄	叁
唸	念
問	问
啓	启
啞	哑
啢	唡
圇	囵
國	国
埡	垭
埬	𪣆
埰	采
執	执
堅	坚
堊	垩
夠	够
婁	娄
婡	𫝫
婦	妇
婭	娅
寀	采
將	将
專	专
屜	屉
崍	崃
崑	昆
崗	岗
崙	仑
崢	峥
崬	岽
帳	帐
帶	带
張	张
強	强
彫	雕
從	从
徠	徕
悵	怅
悽	凄
捨	舍
捫	扪
捱	挨
捲	卷
掃	扫
掄	抡
掆	㧏
掗	挜
掙	挣
掚	𪭵
掛	挂
採	采
啟	启
敎	教
敓	敚
敗	败
敘	叙
㪎	𪯋
斬	斩
旣	既
晝	昼
桱	𣐕
桿	杆
梔	栀
梖	𪱷
梘	枧
條	条
梟	枭
梲	棁
殺	杀
殻	壳
氫	氢
涼	凉
淒	凄
淚	泪
淥	渌
淨	净
淩	凌
淪	沦
淵	渊
淶	涞
淺	浅
烴	烃
牽	牵
猙	狰
珼	𫞥
現	现
產	产
産	产
畢	毕
異	异
眥	眦
眾	众
硃	朱
視	视
紬	䌷
紮	扎
細	细
紱	绂
紲	绁
紳	绅
紵	纻
紹	绍
紺	绀
紼	绋
紿	绐
絀	绌
絁	𫄟
終	终
絃	弦
組	组
絅	䌹
絆	绊
缽	钵
習	习
脛	胫
脣	唇
脥	𣍰
脩	修
脫	脱
莊	庄
莖	茎
莢	荚
莧	苋
處	处
術	术
袞	衮
規	规
覓	觅
訛	讹
訜	𫍛
訝	讶
訞	𫍚
訟	讼
訢	䜣
訣	诀
訥	讷
訨	𫟞
訩	讻
訪	访
設	设
許	许
貧	贫
貨	货
販	贩
貪	贪
貫	贯
責	责
軗	𨐅
軛	轭
軜	𫐇
軟	软
逕	迳
這	这
連	连
釣	钓
釤	钐
釦	扣
釧	钏
釨	𫓦
釩	钒
釲	𫟳
釳	𨰿
釵	钗
釷	钍
釹	钕
釺	钎
閆	闫
閈	闬
閉	闭
陰	阴
陳	陈
陸	陆
頂	顶
頃	顷
飥	饦
飦	𫗞
魚	鱼
鳥	鸟
鹵	卤
麥	麦
傌	㐷
傑	杰
傖	伧
傘	伞
備	备
傢	家
㑳	㑇
𠌥	𠆿
凱	凯
剴	剀
創	创
勛	勋
勝	胜
勞	劳
厤	历
喎	㖞
喚	唤
喪	丧
喫	吃
喬	乔
單	单
喲	哟
噅	𠯠
圍	围
堖	垴
堚	𪣒
堝	埚
堯	尧
報	报
場	场
壺	壶
媈	𫝨
媧	娲
媯	妫
㜄	㚯
𡞵	㛟
尋	寻
嵐	岚
嵗	岁
幀	帧
幃	帏
幾	几
廁	厕
廂	厢
廄	厩
復	复
悶	闷
惡	恶
惱	恼
惲	恽
惻	恻
愜	惬
揀	拣
揚	扬
換	换
揮	挥
揯	搄
棄	弃
棊	棋
棖	枨
棗	枣
棟	栋
棡	㭎
棧	栈
棲	栖
棶	梾
椏	桠
欽	钦
殘	残
殼	壳
氬	氩
氭	𣱝
渙	涣
減	减
渢	沨
渦	涡
測	测
渾	浑
湊	凑
湋	𣲗
湞	浈
湧	涌
湯	汤
溈	沩
無	无
㷍	𤆢
爲	为
猌	𪺽
猶	犹
琱	雕
琺	珐
甦	苏
甯	宁
畫	画
痙	痉
痠	酸
發	发
盜	盗
睍	𪾢
睏	困
䀹	𥅴
硜	硁
硤	硖
硨	砗
硯	砚
稅	税
稈	秆
筆	笔
筍	笋
絍	𫟃
絎	绗
結	结
絕	绝
絙	𫄠
絝	绔
絞	绞
絡	络
絢	绚
絥	𫄢
給	给
絧	𫄡
絨	绒
絰	绖
統	统
絲	丝
絳	绛
絶	绝
脹	胀
腎	肾
腖	胨
菕	𰰨
華	华
菴	庵
菸	烟
萇	苌
萊	莱
虛	虚
衆	众
衕	同
覘	觇
訴	诉
訶	诃
診	诊
註	注
証	证
詀	𧮪
詁	诂
詆	诋
詊	𫟟
詎	讵
詐	诈
詑	𫍡
詒	诒
詓	𫍜
詔	诏
評	评
詖	诐
詗	诇
詘	诎
詛	诅
詞	词
詠	咏
貯	贮
貰	贳
貳	贰
貴	贵
貶	贬
買	买
貸	贷
貺	贶
費	费
貼	贴
貽	贻
貿	贸
賀	贺
賁	贲
軤	轷
軨	𫐉
軫	轸
軬	𫐊
軲	轱
軷	𫐈
軸	轴
軹	轵
軺	轺
軻	轲
軼	轶
𨋢	䢂
週	周
進	进
郵	邮
鄆	郓
鄉	乡
釾	䥺
鈀	钯
鈁	钫
鈃	钘
鈄	钭
鈅	钥
鈆	𫓪
鈇	𫓧
鈈	钚
鈉	钠
鈋	𨱂
鈍	钝
鈎	钩
鈐	钤
鈑	钣
鈒	钑
鈔	钞
鈕	钮
鈖	𫟴
鈗	𫟵
鈛	𫓨
鈞	钧
鈠	𨱁
鈡	钟
鈣	钙
鈥	钬
鈦	钛
鈧	钪
開	开
閌	闶
閍	𨸂
閎	闳
閏	闰
閐	𨸃
閑	闲
閒	闲
間	间
閔	闵
閗	𫔯
陽	阳
隉	陧
隊	队
階	阶
雲	云
韌	韧
項	项
順	顺
頇	顸
須	须
飩	饨
飪	饪
飫	饫
飭	饬
飯	饭
飲	饮
馭	驭
馮	冯
黃	黄
亂	乱
傭	佣
傯	偬
傳	传
傴	伛
債	债
傷	伤
傾	倾
僂	偻
僅	仅
僉	佥
剷	铲
剾	𠛅
勢	势
勣	𪟝
匯	汇
嗆	呛
嗇	啬
嗊	唝
嗎	吗
嗚	呜
嗩	唢
嗰	𠮶
園	园
圓	圆
塊	块
塋	茔
塏	垲
塒	埘
塗	涂
塚	冢
塢	坞
塤	埙
壼	壸
奧	奥
媰	㛀
媼	媪
媽	妈
嫋	袅
𡻕	岁
巰	巯
幹	干
廈	厦
弒	弑
彙	汇
愛	爱
愴	怆
愷	恺
愾	忾
慄	栗
慍	愠
損	损
搖	摇
搗	捣
搵	揾
搶	抢
𩖰	𫠇
暈	晕
暉	晖
暘	旸
會	会
椲	㭏
楇	𣒌
楊	杨
楓	枫
楨	桢
業	业
極	极
榘	矩
歲	岁
毀	毁
準	准
溝	沟
溡	𪶄
溫	温
溮	浉
溳	涢
溼	湿
滄	沧
滅	灭
滙	汇
煇	𪸩
煉	炼
煒	炜
煙	烟
煢	茕
煥	焕
煩	烦
煬	炀
煱	㶽
爺	爷
獁	犸
猻	狲
獅	狮
獊	𪺷
琿	珲
瑋	玮
瑒	玚
畵	画
當	当
痮	𪽪
痾	疴
瘂	痖
盞	盏
睜	睁
睞	睐
碕	埼
碙	𥐻
祿	禄
萬	万
稏	䅉
稜	棱
稟	禀
竪	竖
筧	笕
筴	䇲
節	节
粵	粤
絛	绦
絹	绢
絺	𫄨
綀	𦈌
綁	绑
綃	绡
綆	绠
綇	𦈋
綈	绨
綉	绣
綋	𫟄
綌	绤
綏	绥
綐	䌼
綑	捆
經	经
羣	群
群	群
羥	羟
羨	羡
義	义
聖	圣
肅	肃
腡	脶
腦	脑
腪	𣍯
腫	肿
腳	脚
腸	肠
萴	荝
萵	莴
葉	叶
葒	荭
葝	𫈎
葤	荮
葦	苇
葯	药
葷	荤
蒍	𫇭
虜	虏
號	号
蛺	蛱
蛻	蜕
蜆	蚬
裊	袅
裏	里
補	补
裝	装
裡	里
覛	𫌪
詡	诩
詢	询
詣	诣
試	试
詩	诗
詫	诧
詬	诟
詭	诡
詮	诠
詰	诘
話	话
該	该
詳	详
詵	诜
詷	𫍣
詼	诙
詿	诖
誂	𫍥
誄	诔
誅	诛
誆	诓
誇	夸
誠	诚
貲	赀
賂	赂
賃	赁
賄	贿
賅	赅
資	资
賈	贾
賊	贼
𧵳	䞌
跡	迹
軾	轼
軿	𫐌
較	较
輄	𨐈
輅	辂
輇	辁
輈	辀
載	载
輊	轾
輋	𪨶
農	农
遊	游
運	运
過	过
達	达
違	违
鄒	邹
鄔	邬
鄖	郧
鈮	铌
鈯	𨱄
鈰	铈
鈲	𨱃
鈳	钶
鈴	铃
鈷	钴
鈸	钹
鈹	铍
鈺	钰
鈽	钸
鈾	铀
鈿	钿
鉀	钾
鉁	𨱅
鉅	钜
鉆	钻
鉈	铊
鉉	铉
鉋	铇
鉍	铋
鉑	铂
鉔	𫓬
鉕	钷
鉗	钳
鉚	铆
鉛	铅
鉝	𫟷
鉞	钺
鉠	𫓭
鉢	钵
鉤	钩
鉦	钲
鉬	钼
鉭	钽
鉳	锫
銏	𫟶
龯	𨱆
閘	闸
閝	𫠂
閞	𫔰
隕	陨
雋	隽
電	电
頊	顼
頌	颂
頍	𫠆
頎	颀
頏	颃
預	预
頑	顽
頒	颁
頓	顿
䪴	𫖫
飱	飧
飴	饴
飵	𫗢
飶	𫗣
飼	饲
飽	饱
飾	饰
飿	饳
馯	𫘛
馱	驮
馳	驰
馴	驯
魛	鱽
鳧	凫
鳩	鸠
𪋿	𫧮
黽	黾
僑	侨
僕	仆
僞	伪
僥	侥
僨	偾
僱	雇
劃	划
勩	勚
匱	匮
厭	厌
嗶	哔
嗹	𪡏
嘆	叹
嘍	喽
嘓	啯
嘔	呕
嘖	啧
嘗	尝
嘜	唛
圖	图
團	团
塵	尘
塹	堑
塿	𪣻
墊	垫
壽	寿
夢	梦
夥	伙
奩	奁
奪	夺
奬	奖
嫗	妪
㜢	𡞱
𡠹	㛿
寠	𪧘
寢	寝
實	实
寧	宁
對	对
屢	屡
嵼	𡶴
嵾	㟥
嶁	嵝
嶄	崭
嶇	岖
嶈	𡺃
幓	㡎
幗	帼
幘	帻
幣	币
廎	庼
廕	荫
彃	𪪼
彆	别
愨	悫
愻	𢙏
態	态
慘	惨
慚	惭
慟	恸
慣	惯
慪	怄
慳	悭
慺	㥪
戧	戗
戩	戬
摋	𢫬
摐	𪭢
摑	掴
摜	掼
摟	搂
摳	抠
摶	抟
摺	折
摻	掺
暢	畅
榦	干
榪	杩
榮	荣
榲	榅
榿	桤
構	构
槍	枪
槓	杠
殞	殒
氳	氲
滎	荥
滌	涤
滬	沪
滯	滞
滲	渗
滷	卤
滸	浒
滻	浐
滾	滚
滿	满
漁	渔
漊	溇
漚	沤
漢	汉
漣	涟
漬	渍
漲	涨
漵	溆
漸	渐
熂	𪸕
熅	煴
熉	𤈶
熌	𤇄
熒	荧
熓	𤆡
熗	炝
爾	尔
犖	荦
獃	呆
獄	狱
瑣	琐
瑤	瑶
瑪	玛
瑲	玱
畼	𪽈
瘋	疯
瘍	疡
瘓	痪
瘧	疟
皸	皲
盡	尽
監	监
碩	硕
碭	砀
碸	砜
禍	祸
禎	祯
禕	祎
種	种
稱	称
窩	窝
窪	洼
箇	个
箋	笺
箏	筝
綖	𫄧
綜	综
綞	缍
綟	𫄫
綠	绿
綡	𫟅
綢	绸
綣	绻
綫	线
綬	绶
維	维
綯	绹
綰	绾
綱	纲
網	网
綳	绷
綴	缀
綵	䌽
綸	纶
綹	绺
綺	绮
綻	绽
綽	绰
綾	绫
綿	绵
緄	绲
緇	缁
緊	紧
緋	绯
緍	𦈏
緑	绿
緒	绪
緔	绱
罰	罚
聞	闻
膃	腽
臺	台
與	与
蒐	搜
蒓	莼
蒔	莳
蒕	蒀
蒞	莅
蒭	𫇴
蒼	苍
蓀	荪
蓆	席
蓋	盖
蝕	蚀
製	制
覡	觋
誋	𫍪
誌	志
認	认
誑	诳
誒	诶
誘	诱
誚	诮
語	语
誡	诫
誣	诬
誤	误
誥	诰
誦	诵
誨	诲
說	说
誫	𫍨
説	说
賑	赈
賒	赊
賓	宾
賕	赇
趕	赶
趙	赵
輒	辄
輓	挽
輔	辅
輕	轻
遙	遥
遜	逊
遞	递
遠	远
遡	溯
鄟	𫑘
鉶	铏
鉷	𫟹
鉸	铰
鉺	铒
鉻	铬
鉽	𫟸
鉾	𫓴
鉿	铪
銀	银
銁	𫓲
銂	𫟻
銃	铳
銅	铜
銈	𫓯
銊	𫓰
銍	铚
銑	铣
銓	铨
銖	铢
銘	铭
銚	铫
銛	铦
銜	衔
銠	铑
銣	铷
銥	铱
銦	铟
銨	铵
銩	铥
銪	铕
銫	铯
銬	铐
銱	铞
䤤	𫟺
𨦫	䦀
鋮	铖
閡	阂
閣	阁
閤	合
閥	阀
閨	闺
閩	闽
際	际
韍	韨
頗	颇
領	领
颭	飐
颮	飑
颯	飒
颰	𩙥
颱	台
餃	饺
餄	饸
餅	饼
餉	饷
餌	饵
餎	饹
餏	饻
馹	驲
馼	𫘜
駁	驳
駃	𫘝
骯	肮
魟	𫚉
魢	鱾
鳲	鸤
鳳	凤
鳴	鸣
鳶	鸢
麼	么
麽	么
齊	齐
價	价
儀	仪
儁	俊
儂	侬
億	亿
儈	侩
儉	俭
儎	傤
㒓	𠉂
凙	𪞝
凜	凛
劇	剧
劉	刘
劊	刽
劌	刿
劍	剑
劏	㓥
勱	劢
厲	厉
噓	嘘
嘩	哗
嘪	𪡃
嘮	唠
嘯	啸
嘰	叽
嘳	𪡞
嘵	哓
嘸	呒
嘺	𪡀
嘽	啴
噁	恶
噚	㖊
噝	咝
噴	喷
㗲	𠵾
墜	坠
墮	堕
墰	坛
墲	𪢸
墳	坟
墶	垯
嫵	妩
嫺	娴
嫻	娴
嫿	婳
嬀	妫
嬃	媭
嬇	𫝬
嬈	娆
嬋	婵
嬌	娇
𡢃	㛠
審	审
寫	写
寬	宽
導	导
層	层
嶔	嵚
嶗	崂
嶘	𡺄
嶠	峤
嶢	峣
㠏	㟆
幝	𪩷
幟	帜
幩	𪩸
廚	厨
廝	厮
廟	庙
廠	厂
廡	庑
廢	废
廣	广
彈	弹
徵	徵
徹	彻
慤	悫
慫	怂
慮	虑
慶	庆
慼	戚
慾	欲
憂	忧
憐	怜
憒	愦
憚	惮
憢	𢙒
憤	愤
憫	悯
憮	怃
摯	挚
撈	捞
撊	𪭾
撏	挦
撐	撑
撓	挠
撝	㧑
撟	挢
撣	掸
撥	拨
撧	𪮖
撫	抚
撲	扑
撳	揿
㩋	𪮋
敵	敌
數	数
暫	暂
槤	梿
槧	椠
槨	椁
槫	𣏢
槮	椮
槳	桨
槶	椢
槼	椝
樁	桩
樂	乐
樅	枞
樑	梁
樓	楼
標	标
樞	枢
樠	𣗊
樢	㭤
樣	样
樤	𣔌
樧	榝
樫	㭴
歎	叹
歐	欧
殢	𣨼
殤	殇
毆	殴
毿	毵
氂	牦
漿	浆
潁	颍
潑	泼
潔	洁
潕	𣲘
潙	沩
潚	㴋
潛	潜
潣	𫞗
潤	润
潯	浔
潰	溃
潷	滗
潿	涠
澅	𣶩
澆	浇
澇	涝
澐	沄
澗	涧
𣾷	㳢
濆	𣸣
熚	𤇹
熡	𤋏
熱	热
熲	颎
犛	牦
獎	奖
瑩	莹
瑻	𪻲
瑽	𪻐
璉	琏
璊	𫞩
瘞	瘗
瘡	疮
皚	皑
皺	皱
盤	盘
確	确
碼	码
碽	䂵
磑	硙
禡	祃
穀	谷
窮	穷
窯	窑
範	范
篋	箧
𥯤	𫁳
糉	粽
緓	绬
緗	缃
緘	缄
緙	缂
線	线
緝	缉
緞	缎
緟	𫟆
締	缔
緡	缗
緣	缘
緤	𫄬
緦	缌
編	编
緩	缓
緬	缅
緮	𫄭
緯	纬
緰	𦈕
緱	缑
緲	缈
練	练
緶	缏
緷	𦈉
緸	𦈑
緹	缇
緻	致
緼	缊
䋻	䌾
䋼	𫄮
罵	骂
罷	罢
翫	玩
翬	翚
膕	腘
膚	肤
膞	䏝
膠	胶
膢	𦝼
蓧	𦰏
蓮	莲
蓯	苁
蓴	莼
蓽	荜
蔔	卜
蔘	参
蔞	蒌
蔣	蒋
蔥	葱
蔦	茑
蔭	荫
蔯	𫈟
蝟	猬
蝦	虾
蝨	虱
蝸	蜗
衚	胡
衛	卫
衝	冲
複	复
褌	裈
褘	袆
覥	觍
誕	诞
誰	谁
課	课
誳	𫍮
誴	𫟡
誶	谇
誷	𫍬
誹	诽
誺	𫍧
誼	谊
誾	訚
調	调
諂	谄
諄	谆
談	谈
諉	诿
請	请
諍	诤
諏	诹
諑	诼
諒	谅
論	论
諗	谂
𧩙	䜥
諛	谀
諸	诸
豎	竖
豬	猪
賙	赒
賚	赉
賜	赐
賝	𫎩
賞	赏
賟	𧹖
賠	赔
賡	赓
賢	贤
賣	卖
賤	贱
賦	赋
賧	赕
質	质
賫	赍
賬	账
䝼	䞍
賭	赌
踐	践
𨂐	𫏌
輖	𫐏
輗	𫐐
輛	辆
輜	辎
輝	辉
輞	辋
輟	辍
輢	𫐎
輥	辊
輦	辇
輨	𫐑
輩	辈
輪	轮
輬	辌
適	适
遱	𫐷
遷	迁
鄧	邓
鄭	郑
鄰	邻
鄲	郸
醃	腌
銳	锐
銶	𨱇
銷	销
銹	锈
銻	锑
銼	锉
鋁	铝
鋂	𰾄
鋃	锒
鋅	锌
鋇	钡
鋉	𨱈
鋌	铤
鋏	铗
鋒	锋
鋗	𫓶
鋙	铻
鋝	锊
鋟	锓
鋠	𫓵
鋣	铘
鋤	锄
鋥	锃
鋦	锔
鋨	锇
鋩	铓
鋪	铺
鋭	锐
鋯	锆
鋰	锂
鋱	铽
鋶	锍
𨧀	𬭊
𨧜	䦁
閫	阃
閬	阆
閭	闾
閱	阅
閲	阅
靚	靓
鞏	巩
頜	颌
頡	颉
頦	颏
頫	𫖯
颳	刮
餈	糍
養	养
餑	饽
餒	馁
餓	饿
餔	𫗦
餕	馂
餖	饾
餗	𫗧
餘	馀
駊	𫘟
駎	𩧨
駐	驻
駑	驽
駒	驹
駔	驵
駕	驾
駘	骀
駙	驸
駚	𩧫
駛	驶
駝	驼
駞	𫘞
駟	驷
髮	发
鬧	闹
魥	𩽹
魦	𫚌
魨	鲀
魯	鲁
魴	鲂
魵	𫚍
魷	鱿
䰾	鲃
鳷	𫛛
鳼	𪉃
鳽	𫛚
鳾	䴓
鴀	𫛜
鴃	𫛞
鴅	𫛝
鴆	鸩
鴇	鸨
鴉	鸦
䲰	𪉂
麨	𪎊
麩	麸
麪	麺
齒	齿
儐	傧
儔	俦
儕	侪
儘	尽
冪	幂
劑	剂
勳	勋
噞	𪡋
噠	哒
噥	哝
噦	哕
噯	嗳
噲	哙
噸	吨
噹	当
墻	墙
墾	垦
壇	坛
壈	𡒄
壋	垱
奮	奋
嬙	嫱
嬡	嫒
學	学
嶧	峄
嶨	峃
嶮	崄
廧	𪪞
廩	廪
憊	惫
憑	凭
憖	慭
憲	宪
憶	忆
憸	𪫺
憹	𢙐
懀	𢙓
懌	怿
懍	懔
懎	𢠁
戱	戯
戰	战
撻	挞
撾	挝
撿	捡
擁	拥
擄	掳
擇	择
擋	挡
擓	㧟
擔	担
據	据
曄	晔
曆	历
曇	昙
曉	晓
曊	𪰶
曏	向
樳	桪
樸	朴
樹	树
樺	桦
樿	椫
橈	桡
橋	桥
機	机
橢	椭
橫	横
橯	𣓿
歷	历
殨	㱮
殫	殚
澠	渑
澤	泽
澦	滪
澬	𫞚
澮	浍
澱	淀
澾	㳠
濁	浊
濃	浓
濄	㳡
熾	炽
燁	烨
燈	灯
燉	炖
燒	烧
燙	烫
燜	焖
犞	𪺭
獨	独
獩	𤞃
獪	狯
獫	猃
璝	𪻺
璡	琎
璣	玑
𤩂	𫞧
甌	瓯
瘮	瘆
瘱	𪽷
瘲	疭
瘺	瘘
瘻	瘘
皟	𤾀
盧	卢
瞘	眍
瞜	䁖
瞞	瞒
䁪	𥇢
磚	砖
磠	硵
磣	碜
磧	碛
𥕥	𥐰
禦	御
穇	䅟
穌	稣
積	积
穎	颖
窵	窎
窶	窭
窺	窥
竱	𫁟
築	筑
篔	筼
篘	𥬠
篠	筿
篤	笃
篩	筛
簑	蓑
縈	萦
縉	缙
縊	缢
縋	缒
縍	𫄰
縎	𦈔
縐	绉
縑	缣
縕	缊
縗	缞
縛	缚
縝	缜
縞	缟
縟	缛
縣	县
縧	绦
罃	䓨
朥	𦛨
膩	腻
膹	𪱥
興	兴
舉	举
舘	馆
艙	舱
蔿	𫇭
蕁	荨
蕆	蒇
蕎	荞
蕒	荬
蕓	芸
蕕	莸
蕘	荛
蕝	𫈵
蕢	蒉
蕩	荡
蕪	芜
蕭	萧
蕳	𫈉
薌	芗
螄	蛳
螞	蚂
螢	萤
褲	裤
𧜵	䙊
覦	觎
親	亲
諜	谍
諝	谞
諞	谝
諡	谥
諢	诨
諣	𫍩
諤	谔
諥	𫍳
諦	谛
諧	谐
諫	谏
諭	谕
諮	谘
諯	𫍱
諰	𫍰
諱	讳
諳	谙
諴	𫍯
諶	谌
諷	讽
諺	谚
諼	谖
諾	诺
謀	谋
謁	谒
謂	谓
謔	谑
貓	猫
賰	䞐
賴	赖
賵	赗
赬	赪
踰	逾
踴	踊
輮	𫐓
輯	辑
輳	辏
輷	𫐒
輸	输
輻	辐
輼	辒
辦	办
遲	迟
選	选
遺	遗
遼	辽
鄳	𫑡
鄴	邺
鄶	郐
醖	酝
鋸	锯
鋼	钢
錀	𬬭
錁	锞
錂	𨱋
錄	录
錆	锖
錇	锫
錈	锩
錏	铔
錐	锥
錒	锕
錕	锟
錘	锤
錙	锱
錚	铮
錛	锛
錜	𫓻
錝	𫓽
錟	锬
錠	锭
錡	锜
錢	钱
錤	𫓹
錥	𫓾
錦	锦
錩	锠
錫	锡
錮	锢
錯	错
録	录
錳	锰
錶	表
錸	铼
錼	镎
錽	𫓸
鍀	锝
鍁	锨
鍃	锪
鍄	𨱉
鍅	钫
鍆	钔
鍈	锳
𨨏	𬭛
鍺	锗
閵	𫔴
閶	阊
閹	阉
閻	阎
閼	阏
閽	阍
閾	阈
閿	阌
闍	阇
隨	随
險	险
霑	沾
靜	静
靦	䩄
頤	颐
頭	头
頮	颒
頰	颊
頲	颋
頴	颕
頵	𫖳
頷	颔
頸	颈
頹	颓
頻	频
頽	颓
餚	肴
餛	馄
餜	馃
餞	饯
餡	馅
餦	𫗠
餧	𫗪
館	馆
駡	骂
駢	骈
駤	𫘠
駧	𩧲
駩	𩧴
駫	𫘡
駭	骇
駰	骃
駱	骆
𩣑	䯃
鬨	哄
魺	鲄
魽	𫠐
鮁	鲅
鮃	鲆
鮄	𫚒
鮅	𫚑
鮊	鲌
鮋	鲉
鮍	鲏
鮎	鲇
鮐	鲐
鮑	鲍
鮒	鲋
鮓	鲊
鮣	䲟
䱀	𫚐
𩶘	䲞
鴐	𫛤
鴒	鸰
鴔	𫛡
鴕	鸵
鴗	𫁡
鴛	鸳
鴝	鸲
鴞	鸮
鴟	鸱
鴣	鸪
鴥	𫛣
鴦	鸯
鴨	鸭
麬	𤿲
䴴	𪎋
龍	龙
龜	龟
償	偿
儣	𠆲
優	优
儲	储
勵	励
嚀	咛
嚇	吓
嚌	哜
嚐	尝
壎	埙
壓	压
壗	𡋤
嬣	𪥰
嬤	嬷
嬦	𫝩
嬪	嫔
嬰	婴
孻	𡥧
尷	尴
屨	屦
嶸	嵘
嶹	𫝵
嶺	岭
嶼	屿
嶽	岳
幫	帮
幬	帱
彌	弥
懇	恳
應	应
懞	蒙
懤	㤽
懨	恹
戲	戏
擊	击
擟	𪭧
擠	挤
擣	𢭏
擫	𢬍
擬	拟
擯	摈
擰	拧
擱	搁
㩜	㨫
𢷮	𢫊
斂	敛
斃	毙
曖	暧
檁	檩
檉	柽
檔	档
檜	桧
檟	槚
檢	检
檣	樯
櫛	栉
殭	僵
殮	殓
氈	毡
澩	泶
澀	涩
濕	湿
濘	泞
濚	溁
濛	蒙
濜	浕
濟	济
濤	涛
濧	㳔
濫	滥
濰	潍
濱	滨
營	营
燦	灿
燬	毁
燭	烛
燴	烩
燶	㶶
牆	墙
獮	狝
獰	狞
獱	㺍
獲	获
璦	瑷
璫	珰
璯	㻅
環	环
療	疗
癆	痨
癇	痫
癉	瘅
盨	𪾔
盪	荡
䀉	𥁢
瞤	𥆧
瞭	瞭
瞶	瞆
矯	矫
磯	矶
磽	硗
磾	䃅
礄	硚
禪	禅
篳	筚
篸	𥮾
簀	箦
簂	𫂆
簍	篓
糝	糁
糞	粪
縫	缝
縬	𦈚
縭	缡
縮	缩
縰	𫄳
縱	纵
縲	缧
縳	䌸
縴	纤
縵	缦
縶	絷
縷	缕
縸	𫄲
縹	缥
縺	𦈐
總	总
績	绩
繂	𫄴
繃	绷
繅	缫
繆	缪
繈	𫄶
耬	耧
聯	联
聰	聪
聲	声
聳	耸
膽	胆
膾	脍
膿	脓
臉	脸
臨	临
艱	艰
蕷	蓣
蕽	𫇽
薀	蕰
薆	𫉁
薈	荟
薊	蓟
薑	姜
薔	蔷
薘	荙
薟	莶
薦	荐
𦾟	𦶻
虧	亏
螮	䗖
螻	蝼
螿	螀
蟂	𫋇
蟄	蛰
蟈	蝈
蟎	螨
褳	裢
褸	褛
褻	亵
襀	𫌀
𧝞	䘛
覬	觊
覯	觏
謄	誊
謅	诌
謆	𫍸
謉	𫍷
謊	谎
謎	谜
謏	𫍲
謐	谧
謖	谡
謗	谤
謙	谦
謚	谥
講	讲
謝	谢
謠	谣
謡	谣
䜀	䜧
賺	赚
賻	赙
購	购
賽	赛
趨	趋
蹌	跄
輾	辗
輿	舆
轀	辒
轂	毂
轄	辖
轅	辕
邁	迈
還	还
醜	丑
醞	酝
醟	蒏
醣	糖
錨	锚
鍇	锴
鍉	𫔂
鍊	炼
鍋	锅
鍍	镀
鍒	𫔄
鍔	锷
鍘	铡
鍚	钖
鍛	锻
鍠	锽
鍤	锸
鍥	锲
鍩	锘
鍬	锹
鍮	𨱎
鍰	锾
鍵	键
鍶	锶
鍼	针
鍾	锺
鎂	镁
鎄	锿
鎇	镅
鎡	镃
鎯	𨱍
闃	阒
闆	板
闇	暗
闈	闱
闊	阔
闋	阕
闌	阑
隯	陦
隱	隐
隸	隶
雖	虽
鞝	绱
韓	韩
顂	𩓋
顃	𩖖
顅	𫖶
顆	颗
𩓥	𫖵
颶	飓
颷	𩙪
𩗴	𫗉
餪	𫗬
餫	𫗥
餬	糊
餭	𫗮
餱	糇
餳	饧
餵	喂
餷	馇
駶	𩧺
駸	骎
駻	𫘣
駿	骏
騁	骋
騂	骍
騃	𫘤
鮆	𫚖
鮚	鲒
鮜	鲘
鮝	鲞
鮞	鲕
鮟	𩽾
鮤	𫚓
鮦	鲖
鮪	鲔
鮫	鲛
鮭	鲑
鮮	鲜
鮯	𫚗
鮰	𫚔
鮳	鲓
鮺	鲝
鴜	𪉈
鴮	𫛦
鴯	鸸
鴰	鸹
鴲	𪉆
鴳	𫛩
鴴	鸻
鴷	䴕
鴻	鸿
鴽	𫛪
鴿	鸽
鵁	䴔
鵂	鸺
鵃	鸼
鵧	𫛨
麯	曲
點	点
黿	鼋
齋	斋
齔	龀
儭	𠋆
叢	丛
嚕	噜
嚙	啮
嚛	𪠸
㘉	𠰱
嚮	向
壘	垒
壙	圹
嬸	婶
嬻	𪥿
屩	𪨗
懟	怼
懣	懑
㦛	𢗓
擲	掷
擴	扩
擷	撷
擺	摆
擻	擞
擼	撸
擽	㧰
擾	扰
攄	摅
攆	撵
斷	断
檭	𣘴
檮	梼
檯	台
檳	槟
檵	𪲛
檸	柠
檻	槛
櫃	柜
櫅	𪲎
歟	欤
歸	归
殯	殡
濺	溅
濼	泺
濾	滤
濿	𪵱
瀂	澛
瀃	𣽷
瀅	滢
瀆	渎
瀇	㲿
瀉	泻
瀋	渖
瀏	浏
瀦	潴
燻	熏
燼	烬
燾	焘
爃	𫞡
獵	猎
獷	犷
璵	玙
璸	瑸
璼	𫞨
璾	𫞦
璿	璇
甕	瓮
癐	𤶊
癒	愈
癘	疠
癤	疖
瞼	睑
礆	硷
礎	础
礒	𥐟
禮	礼
穠	秾
穡	穑
穢	秽
竄	窜
竅	窍
簞	箪
簡	简
簢	𫂃
簣	篑
簫	箫
糧	粮
繏	𦈝
繐	𰬸
繒	缯
繓	𦈛
織	织
繕	缮
繚	缭
繞	绕
繟	𦈎
繡	绣
繢	缋
罈	坛
羵	𫅗
翹	翘
耮	耢
聵	聩
聶	聂
職	职
臍	脐
臏	膑
𦢈	𣍨
舊	旧
薩	萨
薳	䓕
薴	苧
薵	䓓
薹	薹
薺	荠
藉	藉
藍	蓝
藎	荩
蟘	𫋌
蟜	𫊸
蟣	虮
蟬	蝉
蟯	蛲
蟲	虫
蟳	𫊻
襇	裥
襉	裥
襏	袯
襓	𫋹
覆	覆
覲	觐
觴	觞
謨	谟
謫	谪
謬	谬
謭	谫
謯	𫍹
謱	𫍴
謳	讴
謸	𫍵
謹	谨
謾	谩
豐	丰
豵	𫎆
貗	𫎌
貙	䝙
賾	赜
贃	𧹗
贄	贽
贅	赘
蹔	𫏐
蹕	跸
蹟	迹
蹠	跖
蹣	蹒
蹤	踪
軀	躯
轆	辘
轇	𫐖
轉	转
轊	𫐕
邇	迩
鄺	邝
醫	医
醬	酱
釐	厘
鎈	𫟿
鎊	镑
鎌	镰
鎍	𫔅
鎔	镕
鎖	锁
鎘	镉
鎙	𫔈
鎚	锤
鎛	镈
鎝	𨱏
鎞	𫔇
鎢	钨
鎣	蓥
鎦	镏
鎧	铠
鎪	锼
鎬	镐
鎭	镇
鎮	镇
鎰	镒
鎲	镋
鎳	镍
鎵	镓
鎶	鿔
鎷	𨰾
鎸	镌
鎿	镎
䥄	𫠀
䥇	䦂
闐	阗
闑	𫔶
闒	阘
闓	闿
闔	阖
闕	阙
闖	闯
雙	双
雛	雏
雜	杂
雞	鸡
離	离
霢	霡
霣	𫕥
靝	靔
鞦	秋
韙	韪
韚	𫠅
題	题
額	额
顎	颚
顏	颜
顒	颙
顓	颛
顔	颜
颸	飔
颺	飏
餶	馉
餸	𩠌
餺	馎
餼	饩
餾	馏
餿	馊
饁	馌
騄	𫘧
騅	骓
騉	𫘥
騊	𫘦
騌	骔
騍	骒
騎	骑
騏	骐
𩣺	𩧼
鬆	松
鬩	阋
魎	魉
鮵	𫚛
鮶	鲪
鮸	𩾃
鮿	𫚚
鯀	鲧
鯁	鲠
鯄	𩾁
鯆	𫚙
鯇	鲩
鯉	鲤
鯊	鲨
鯒	鲬
鯽	鲫
鵊	𫛥
鵐	鹀
鵑	鹃
鵒	鹆
鵓	鹁
鵚	𪉍
鵜	鹈
鵝	鹅
鵟	𫛭
鵠	鹄
麲	𪎉
鼂	鼌
鼕	冬
齕	龁
龎	厐
勸	劝
厴	厣
嚥	咽
嚦	呖
嚧	𠰷
嚨	咙
𡃤	𪢐
壚	垆
壜	坛
壞	坏
壟	垄
壠	垅
壢	坜
寵	宠
廬	庐
龐	庞
徿	𪫌
懲	惩
懶	懒
懷	怀
攋	𪮶
攏	拢
曠	旷
櫓	橹
櫚	榈
櫝	椟
櫞	橼
櫟	栎
櫠	𪲮
櫥	橱
櫫	橥
櫧	槠
殰	㱩
氌	氇
瀕	濒
瀘	泸
瀝	沥
瀟	潇
瀠	潆
瀧	泷
瀨	濑
爄	𤇃
爇	𦶟
爍	烁
牘	牍
犢	犊
獸	兽
獺	獭
璽	玺
瓄	𪻨
瓊	琼
𤪺	㻘
疇	畴
癟	瘪
癡	痴
矇	蒙
矉	𪾸
礙	碍
禰	祢
禱	祷
穩	稳
穫	获
簹	筜
簽	签
簾	帘
𥵃	𥱔
繨	𫄤
繩	绳
繪	绘
繫	系
繬	𫄱
繭	茧
繮	缰
繯	缳
繰	缲
繳	缴
繶	𫄷
繷	𫄣
繸	䍁
繹	绎
羅	罗
羆	罴
羶	膻
翽	翙
臗	𣎑
臘	腊
艣	𫇛
艤	舣
藝	艺
藥	药
藪	薮
藭	䓖
藴	蕴
藷	𫉄
蠁	蚃
蟶	蛏
蟻	蚁
蠀	𧏗
蠅	蝇
蠆	虿
蠍	蝎
襖	袄
襗	𫋷
襘	𫋻
襝	裣
襠	裆
覈	核
覷	觑
觶	觯
譁	哗
譂	𫟠
譆	𫍻
證	证
譊	𫍢
譎	谲
譏	讥
譑	𫍤
譖	谮
識	识
譙	谯
譚	谭
譜	谱
豶	豮
贇	赟
贈	赠
贉	𫎫
贊	赞
贋	赝
蹳	𫏆
蹺	跷
蹻	𫏋
轍	辙
轎	轿
轐	𫐗
轔	辚
辭	辞
邊	边
醱	酦
鎩	铩
鏃	镞
鏆	𨱌
鏇	镟
鏈	链
鏉	𨱒
鏌	镆
鏍	镙
鏐	镠
鏑	镝
鏗	铿
鏘	锵
鏚	𬭭
鏜	镗
鏝	镘
鏞	镛
鏟	铲
鏡	镜
鏢	镖
鏤	镂
鏥	𫔊
鏦	𫓩
鏨	錾
鏰	镚
鏹	镪
䥑	鿏
關	关
隴	陇
難	难
霧	雾
韜	韬
韝	鞲
韞	韫
韻	韵
顗	𫖮
願	愿
顙	颡
顛	颠
類	类
颻	飖
颼	飕
颾	𩙫
飀	飗
饃	馍
饅	馒
饈	馐
饉	馑
騔	𩨀
騖	骛
騙	骗
騚	𩨊
騜	𫘩
騝	𩨃
騟	𩨈
騠	𫘨
騤	骙
騧	䯄
䮝	𩧰
鬍	胡
鯔	鲻
鯕	鲯
鯖	鲭
鯗	鲞
鯛	鲷
鯝	鲴
鯞	𫚡
鯡	鲱
鯢	鲵
鯤	鲲
鯧	鲳
鯨	鲸
鯪	鲮
鯫	鲰
鯬	𫚞
鯰	鲶
鯱	𩾇
鯴	鲺
鵡	鹉
鵩	𫛳
鵪	鹌
鵫	𫛱
鵬	鹏
鵮	鹐
鵯	鹎
鵰	雕
鵲	鹊
鵷	鹓
鵾	鹍
鶄	䴖
鶇	鸫
鶉	鹑
鶊	鹒
鶌	𫛵
䳢	𫛰
麗	丽
麳	𪎌
麴	曲
齗	龂
嚲	亸
嚳	喾
嚴	严
嚶	嘤
壣	𪤚
孃	娘
孄	𫝮
孆	𫝭
㜷	𡝠
孾	𪧀
寶	宝
巊	𪩎
懸	悬
懺	忏
攔	拦
攖	撄
攙	搀
斅	𢽾
斆	敩
曥	𣆐
曨	昽
朧	胧
櫨	栌
櫪	枥
櫬	榇
櫱	蘖
櫳	栊
瀰	㳽
瀲	潋
瀾	澜
爐	炉
爖	𤇭
𤑳	𤎻
犧	牺
𤜆	𪺪
獻	献
獼	猕
瓏	珑
癢	痒
癥	征
礦	矿
礪	砺
礫	砾
礬	矾
穭	穞
竇	窦
競	竞
籃	篮
籅	𥫣
籋	𥬞
籌	筹
糰	团
繻	𦈡
繼	继
繽	缤
繾	缱
繿	䍀
纁	𫄸
𦆲	𫟇
罌	罂
聹	聍
聻	𫆏
臚	胪
艦	舰
藶	苈
藹	蔼
藺	蔺
蘀	萚
蘄	蕲
蘆	芦
蘇	苏
蘊	蕴
蘋	𬞟
蘢	茏
蠐	蛴
蠑	蝾
蠔	蚝
蠙	𧏖
襤	褴
覹	𫌭
覺	觉
觸	触
譞	𫍽
譟	噪
譨	𫍦
譫	谵
譭	毁
譯	译
議	议
贍	赡
贏	赢
躂	跶
躉	趸
轗	𫐘
辮	辫
醶	𫑷
釋	释
鏵	铧
鏷	镤
鏺	䥽
鏽	锈
鏾	𫔌
鐃	铙
鐄	𨱑
鐇	𫔍
鐈	𫓱
鐋	铴
鐍	𫔎
鐎	𨱓
鐏	𨱔
鐐	镣
鐒	铹
鐓	镦
鐔	镡
鐘	钟
鐙	镫
鐝	镢
鐠	镨
鐥	䦅
鐦	锎
鐧	锏
鐨	镄
𨭆	𬭶
𨭎	𬭳
鐯	䦃
鐼	𫔁
闞	阚
闠	阓
闡	阐
韛	𫖔
韠	𫖒
響	响
顢	颟
顣	𫖹
飄	飘
饊	馓
饋	馈
饌	馔
饑	饥
饒	饶
騪	𩨄
騫	骞
騭	骘
騮	骝
騰	腾
騱	𫘬
騴	𫘫
騵	𫘪
騶	驺
騷	骚
騸	骟
𩥇	𩨍
𩥉	𩧱
鯶	𩽼
鯷	鳀
鯾	𫚣
鯿	鳊
鰁	鳈
鰂	鲗
鰃	鳂
鰆	䲠
鰈	鲽
鰉	鳇
鰋	𫚢
鰌	䲡
鰍	鳅
鰏	鲾
鰐	鳄
鰑	𫚊
鰒	鳆
鰓	鳃
鰕	𫚥
鰛	鳁
鰠	鳋
鶒	𫛶
鶓	鹋
鶖	鹙
鶗	𫛸
鶘	鹕
鶚	鹗
鶡	鹖
鶥	鹛
鶦	𫛷
鶩	鹜
鶪	䴗
鶿	鹚
鹹	咸
麵	麺
黨	党
齙	龅
齟	龃
齠	龆
齡	龄
齣	出
龑	䶮
儷	俪
儸	㑩
儺	傩
嚽	𪢕
囀	啭
囁	嗫
囂	嚣
囃	𠱞
𡅏	𠲥
孇	𪥫
屬	属
巋	岿
懼	惧
懾	慑
攛	撺
攜	携
攝	摄
斕	斓
櫸	榉
櫻	樱
欄	栏
欅	榉
殲	歼
灃	沣
灄	滠
灍	𫞝
爛	烂
瓔	璎
癧	疬
癩	癞
㿗	𤻊
矑	𪾦
矓	眬
礮	𪿫
礱	砻
竈	灶
籔	䉤
糲	粝
纇	颣
纈	缬
纊	纩
續	续
纍	累
纏	缠
蘚	藓
蘞	蔹
蘟	𦻕
蘭	兰
蠟	蜡
蠣	蛎
衊	蔑
襪	袜
襬	䙓
覼	𫌨
覽	览
譅	𰶎
譴	谴
護	护
譸	诪
譽	誉
𧭈	𫍾
贐	赆
贑	𫎬
贓	赃
贔	赑
躊	踌
躋	跻
躍	跃
躎	䟢
轟	轰
辯	辩
鐪	𫓺
鐫	镌
鐮	镰
鐲	镯
鐳	镭
鐵	铁
鐶	镮
鐸	铎
鐺	铛
鐽	𫟼
鐿	镱
鑀	𰾭
闢	辟
闤	阛
闥	闼
靧	𫖃
鞽	鞒
鞾	𫖇
顥	颢
顧	顾
飆	飙
飈	飚
饗	飨
饘	𫗴
騻	𫘭
騼	𫠋
騾	骡
驀	蓦
驁	骜
驂	骖
驃	骠
驄	骢
驅	驱
龭	𩨎
髏	髅
鬖	𩭹
鬹	鬶
鰜	鳒
鰟	鳑
鰣	鲥
鰤	𫚕
鰥	鳏
鰦	𫚤
鰧	䲢
鰨	鳎
鰩	鳐
鰫	𫚦
鰭	鳍
鰮	鳁
䱷	䲣
䱽	䲝
鶬	鸧
鶭	𫛯
鶯	莺
鶰	𫛫
鶲	鹟
鶴	鹤
鶹	鹠
鶺	鹡
鶻	鹘
鶼	鹣
鷀	鹚
鷁	鹢
鷂	鹞
鷄	鸡
鷅	𫛽
鷉	䴘
鷊	鹝
鹺	鹾
齎	赍
齜	龇
齦	龈
齧	啮
齩	𫜪
儻	傥
儼	俨
囅	冁
囈	呓
囉	啰
孋	㛤
孌	娈
孿	孪
巒	峦
巔	巅
巗	𪨷
彎	弯
彲	彨
攢	攒
攤	摊
欇	𪳍
權	权
欍	𣐤
歡	欢
灑	洒
灒	𪷽
灕	漓
灘	滩
玀	猡
瓕	𤦀
疊	叠
癬	癣
癭	瘿
癮	瘾
竊	窃
籙	箓
籛	篯
籜	箨
籟	籁
籠	笼
糴	籴
罎	坛
聽	听
聾	聋
臟	脏
𦧺	𫇘
艫	舻
蠦	𫊮
蠨	蟏
襯	衬
襰	𧝝
襲	袭
覿	觌
譾	谫
讀	读
讅	谉
贖	赎
贗	赝
躑	踯
躒	跞
躓	踬
躕	蹰
躚	跹
轠	𫐙
轡	辔
轢	轹
酇	酂
酈	郦
鑄	铸
鑉	𫠁
鑊	镬
鑌	镔
鑑	鉴
鑒	鉴
鑔	镲
霼	𪵣
霽	霁
韁	缰
韃	鞑
顫	颤
飋	𫗋
驊	骅
驋	𩧯
驌	骕
驍	骁
驏	骣
驓	𫘯
驕	骄
髒	脏
鬚	须
鰱	鲢
鰲	鳌
鰳	鳓
鰵	鳘
鰷	鲦
鰹	鲣
鰺	鲹
鰻	鳗
鰼	鳛
鰽	𫚧
鰾	鳔
鱂	鳉
鱄	𫚋
鱅	鳙
鱆	𫠒
鱇	𩾌
鱈	鳕
䲁	鳚
䲅	𫚜
鱉	鳖
鷐	𫜀
鷓	鹧
鷔	𪉑
鷖	鹥
鷗	鸥
鷙	鸷
鷚	鹨
鷩	𫜁
鼴	鼹
齪	龊
齬	龉
龓	𫜲
龔	龚
龕	龛
劚	㔉
囌	苏
㘚	㘎
巖	岩
巘	𪩘
戀	恋
攣	挛
攪	搅
曬	晒
欏	椤
欐	𪲔
欑	𪴙
欒	栾
毊	𪵑
灙	𣺼
𤓎	𤎺
玁	𤞤
瓚	瓒
癰	痈
籤	签
纓	缨
纔	才
纖	纤
臢	臜
蘺	蓠
蘿	萝
蠱	蛊
襴	襕
變	变
讋	詟
讌	䜩
讎	雠
贚	𫎦
躘	𨀁
轣	𫐆
轤	轳
邏	逻
邐	逦
鑕	锧
鑞	镴
鑠	铄
鑣	镳
鑥	镥
𨯅	䥿
靨	靥
顬	颥
顯	显
饜	餍
驗	验
驙	𫘰
驚	惊
驛	驿
體	体
鬠	𫘽
鱊	𫚪
鱒	鳟
鱔	鳝
鱖	鳜
鱗	鳞
鱘	鲟
鷣	𫜃
鷤	𫛴
鷥	鸶
鷦	鹪
鷨	𪉊
鷫	鹔
鷯	鹩
鷲	鹫
鷳	鹇
鷴	鹇
鷷	𫜄
鷸	鹬
黲	黪
黴	霉
齏	齑
齭	𫜭
齯	𫠜
齰	𫜬
囑	嘱
囒	𪢠
壩	坝
孎	𡠟
攬	揽
欓	𣗋
灝	灏
灡	㳕
瓛	𤩽
癱	瘫
癲	癫
籪	簖
䉶	𫁷
纗	𫄹
羈	羁
艷	艳
蠶	蚕
襵	𫌇
讒	谗
讓	让
讕	谰
讖	谶
贛	赣
躝	𨅬
釀	酿
鑪	𬬻
靂	雳
靄	霭
靆	叇
靈	灵
韆	千
顰	颦
驟	骤
髕	髌
鬢	鬓
魘	魇
鱝	鲼
鱟	鲎
鱠	鲙
鱢	𫚫
鱣	鳣
鱤	鳡
鱧	鳢
鷺	鹭
鷹	鹰
鷽	鸴
鷿	𬸯
鸂	㶉
鸇	鹯
鸊	䴙
䴉	鹮
鹼	碱
鹽	盐
齲	龋
齴	𫜮
齶	腭
齷	龌
壪	塆
廳	厅
斸	𣃁
欖	榄
欘	𣚚
灣	湾
爥	𪹳
籩	笾
籬	篱
籮	箩
糶	粜
纘	缵
纚	𫄥
臠	脔
虆	蔂
蠻	蛮
觀	观
贜	赃
躡	蹑
躥	蹿
釁	衅
鑭	镧
鑰	钥
鑱	镵
鑲	镶
𨰃	𫔉
靉	叆
顱	颅
饞	馋
饟	𫗵
髖	髋
鱨	鲿
鱭	鲚
鱮	𫚈
鱯	鳠
鸋	𫛢
鸌	鹱
鸏	鹲
黌	黉
鼉	鼍
圞	𪢮
彠	彟
灤	滦
矚	瞩
讚	赞
趲	趱
躦	躜
釃	酾
鑴	𫔔
鑷	镊
鑹	镩
韉	鞯
驢	驴
䮾	𩧪
驥	骥
鱲	𫚭
黶	黡
灧	滟
纜	缆
蠾	𧑏
讜	谠
讞	谳
躪	躏
軉	𨉗
釅	酽
鑼	锣
鑽	钻
鑾	銮
顳	颞
顴	颧
饠	𫗩
驤	骧
驦	骦
鬮	阄
鱷	鳄
鱸	鲈
鸕	鸬
鸗	𫛟
黷	黩
戇	戆
𢺳	𪮳
欞	棂
爧	𫞠
𤫩	㻏
豔	艳
鑿	凿
钁	䦆
钂	镋
驨	𫘱
䯀	䯅
鸘	鹴
鸚	鹦
驪	骊
鬱	郁
鸛	鹳
麷	𫜑
䖅	𫟑
饢	馕
驫	骉
鱺	鲡
鸝	鹂
鸞	鸾
灩	滟
籲	吁
齾	𫜰
㑮	𫝈
㑯	㑔
㑶	㐹
𠏢	𠉗
𠐊	𫝋
㓄	𪠟
𠗣	㓆
㓨	刾
𠞆	𠛆
㔋	𪟎
𪟖	𠛾
𠠎	𠚳
𠬙	𪠡
㖮	𪠵
𠽃	𪠺
㗿	𪡛
𠿕	𪜎
𡂡	𪢒
𡃄	𪡺
𡃕	𠴛
㘓	𪢌
㘔	𫬐
𡄔	𠴢
𡄣	𠵸
𡅯	𪢖
𡑭	𡋗
𡓁	𪤄
𡓾	𡋀
𡔖	𡍣
㜏	㛣
㜐	𫝧
𡟫	𫝪
㜗	𡞋
𡮉	𡭜
𡮣	𡭬
㞞	𪨊
𡳳	𡳃
𡸗	𪨩
𡹬	𪨹
㟺	𪩇
𡽗	𡸃
𡾱	㟜
𡿖	𪩛
㢗	𪪑
㢝	𢋈
𢍰	𪪴
㥮	㤘
㦎	𢛯
𢠼	𢙑
㦞	𪫷
𢣐	𪬚
𢣚	𢘝
𢣭	𢘞
𢤩	𪫡
𢤱	𢘙
𢤿	𪬯
𢯷	𪭝
㨻	𪮃
𢶒	𪭯
𢶫	𢫞
㩳	㧐
𢹿	𢬦
㩵	擜
𣈶	暅
𠁞	𠀾
𣋋	𣈣
𣍐	𫧃
𣙎	㭣
㯤	𣘐
𣜬	𪳗
𣝕	𣘷
𣞻	𣘓
𣠩	𣞎
𣠲	𣑶
㰙	𣗙
𣯩	𣯣
𣯴	𣭤
𣯶	毶
㵗	𣳆
𣽏	𪶮
𪷓	𣶭
𣿉	𣶫
㵾	𪷍
𤁣	𣺽
㶆	𫞛
𤄷	𪶒
𤅶	𣷷
㷿	𤈷
㸇	𤎺
𤑹	𪹀
𤒎	𤊀
𤒻	𪹹
𤓌	𪹠
𤓩	𤊰
𤘀	𪺣
𤛮	𤙯
𤛱	𫞢
㹽	𫞣
𤠮	𪺸
㺏	𤠋
㺜	𪺻
𤢟	𤝢
𤢻	𢢐
㻶	𪼋
𤬅	𪼴
𤳷	𪽝
𤳸	𤳄
𤷃	𪽭
𤸫	𤶧
𤺔	𪽴
㿖	𪽮
㿧	𤽯
𥊝	𥅿
𥌃	𥅘
䁻	䀥
䂎	𥎝
𥏝	𪿊
𥖅	𥐯
䃮	鿎
𥖲	𪿞
𥗇	𪿵
𥜐	𫀓
𥜰	𫀌
䅐	𫀨
𥞵	𥞦
䅳	𫀬
𥢢	䅪
𥢶	𫞷
𥢷	𫀮
䆉	𫁂
𥨐	𥧂
𥪂	𥩺
䉑	𫁲
䉙	𥬀
𥴨	𫂖
𥴼	𫁺
𥵊	𥭉
䉬	𫂈
𥶽	𫁱
䉲	𥮜
𥸠	𥮋
𥻦	𫂿
𥼽	𥹥
䊭	𥺅
𥽖	𥺇
䊺	𫄚
䋃	𫄜
𥾯	𫄝
䋔	𫄞
𥿊	𦈈
䋙	䌺
䋚	䌻
䋦	𫄩
𦀖	𫄦
䋹	䌿
䋿	𦈓
𦂅	𦈒
䌈	𦈖
䌋	𦈘
𦃄	𦈗
𦃩	𫄯
䌖	𦈜
𦅇	𫄪
𦅈	𫄵
䌝	𦈟
䌟	𦈞
䌥	𦈠
䌰	𦈙
䍤	𫅅
䍦	䍠
䍽	𦍠
𦒀	𫅥
䎙	𫅭
𦔖	𫅼
䎱	䎬
𦘧	𡳒
𦟼	𫆝
𦠅	𫞅
𦡝	𫆫
𦣎	𦟗
𦪙	䑽
𦪽	𦨩
𦱌	𫇪
鿓	鿒
䕤	𫟕
䕳	𦰴
䗅	𫊪
𧎈	𧌥
𧒯	𫊹
䗿	𧉞
𧔥	𧒭
𧕟	𧉐
𧜗	䘞
䙔	𫋲
䙡	䙌
𧞫	𫌋
𧟀	𧝧
䙱	𧜭
𧡴	𫌫
𧢄	𫌬
䚩	𫌯
䛄	𫍠
𧦝	𫍞
𧦧	𫍟
鿁	䜤
䛳	𫍫
𧩕	𫍭
𧩼	𫍶
𧫝	𫍺
𧬤	𫍼
䜖	𫟢
𧭹	𫍐
𧳟	𧳕
䝭	𫎧
𧶔	𧹓
䝻	𧹕
𧶧	䞎
𧷎	𪠀
䞈	𧹑
𧸘	𫎨
䞋	𫎪
𧹈	𪥠
䞓	𫎭
䟃	𫎺
䟆	𫎳
𧽯	𫎸
䟐	𫎱
䠆	𫏃
𨄣	𨀱
𨅍	𨁴
𨆪	𫏕
𨇁	𧿈
𨇞	𨅫
𨇤	𫏨
𨇰	𫏞
𨇽	𫏑
䠱	𨅛
𨈊	𨂺
𨈌	𨄄
𨊰	䢀
𨊸	䢁
𨊻	𨐆
䡐	𫟤
𨌈	𫐍
䡩	𫟥
𨍰	𫐔
𨎌	𫐋
䡵	𫟦
𨎮	𨐉
𨏠	𨐇
𨏥	𨐊
䢨	𨑹
𨞺	𫟫
𨟊	𫟬
𨢿	𨡙
𨣈	𨡺
𨣞	𨟳
𨣧	𨠨
𨤻	𨤰
𨥛	𨱀
𨥟	𫓫
𫒡	𫓷
𨧰	𫟽
𨧱	𨱊
𨨛	𫓼
𨨢	𫓿
𨩰	𫟾
𨪕	𫓮
𨫒	𨱐
䥗	𫔋
𨬖	𫔏
𨭖	𫔑
𨭸	𫔐
𨮂	𨱕
䥩	𨱖
𨮳	𫔒
䥯	𫔆
䥱	䥾
𨯟	𫔓
𨰋	𫓳
𨰥	𫔕
𨰲	𫔃
𨲳	𫔖
𨳑	𨸁
𨳕	𨸀
䦘	𨸄
䦛	䦶
𨴗	𨸅
䦟	䦷
𨴹	𫔲
䦯	𫔵
𨵩	𨸆
𨵸	𨸇
𨶀	𨸉
𨶏	𨸊
𨶮	𨸌
𨶲	𨸋
䦳	𨷿
𨷲	𨸎
䧢	𨸟
𨼳	𫔽
𨽏	𨸘
𩀨	𫕚
𩅙	𫕨
䪊	𫖅
䪏	𩏼
𩎖	𫖑
𩎢	𩏾
𩏂	𫖓
䪗	𩐀
䪘	𩏿
𩏠	𫖖
𩏪	𩏽
𩏷	𫃗
𩑔	𫖪
䪾	𫖬
𩒎	𫖭
䫀	𫖱
䫂	𫖰
𩓣	𩖕
𩔑	𫖷
䫟	𫖲
𩔳	𫖴
䫴	𩖗
䫶	𫖺
䫻	𫗇
䫾	𫠈
𩗀	𩙦
𩗓	𫗈
𩘀	𩙩
䬓	𫗊
䬘	𩙮
𩘝	𩙭
䬝	𩙯
𩘹	𩙨
𩘺	𩙬
𩙈	𩙰
䬞	𩙧
䬧	𫗟
𩚛	𩟿
𩚥	𩠀
𩚩	𫗡
𩚵	𩠁
𩛆	𩠂
𩛌	𫗤
䭀	𩠇
𩛡	𫗨
𩛩	𩠃
䭃	𩠈
𩜇	𩠉
𩜦	𩠆
𩜵	𩠊
𩝔	𩠋
䭑	𫗱
䭔	𫗰
𩝽	𫗳
𩞄	𩠎
𩞦	𩠏
𩞯	䭪
𩟐	𩠅
𩟗	𫗚
𩠴	𩠠
𩡣	𩡖
𩡺	𩧦
䭿	𩧭
䮄	𫠊
𩢡	𩧬
𩢴	𩧵
𩢸	𩧳
𩢾	𩧮
𩣏	𩧶
𩣫	𩧸
𩣵	𩧻
𩤊	𩧩
䮞	𩨁
䮠	𩧿
𩤙	𩨆
𩤲	𩨉
𩤸	𩨅
𩥄	𩨋
𩥑	𩨌
䮫	𩨇
䮰	𫘮
䮳	𩨏
𩦠	𫠌
𩧆	𩨐
䯤	𩩈
𩭙	𩬣
𩯁	𫙂
𩯳	𩯒
𩰀	𩬤
𩰹	𩰰
𩳤	𩲒
𩴵	𩴌
𩵦	𫠏
𩵩	𩽺
𩵹	𩽻
䱁	𫚏
𩶁	𫚎
𩶰	𩽿
𩶱	𩽽
𩷰	𩾄
䱙	𩾈
䱧	𫚠
𩸃	𩾅
𩸄	𫚝
𩸡	𫚟
𩸦	𩾆
䱬	𩾊
䱰	𩾋
䱸	𫠑
𩻗	𫚨
𩻬	𫚩
𩻮	𫚘
䲖	𩾂
䲘	鳤
𩼶	𫚬
𩽇	𩾎
𩿅	𫠖
𩿤	𫛠
𩿪	𪉄
𪀖	𫛧
𪀦	𪉅
𪀾	𪉋
𪁈	𪉉
䳜	𫛬
𪁖	𪉌
䳤	𫛮
𪂆	𪉎
䳧	𫛺
䳫	𫛼
𪃍	𪉐
𪃏	𪉏
𪃒	𫛻
𪃧	𫛹
𪄆	𪉔
𪄕	𪉒
𪅂	𫜂
䴋	𫜅
𪆷	𫛾
𪇳	𪉕
𪈼	𱊜
𪉸	𫜊
䴬	𪎈
䴱	𫜒
𪌭	𫜓
䴽	𫜔
𪍠	𫜕
䵳	𪑅
䵴	𫜙
𪓰	𫜟
𪔵	𪔭
䶕	𫜨
𪘀	𪚏
𫜦	𫜫
𪘯	𪚐
𪙏	𫜯
䶲	𫜳
